NO ./pics/greystone.xpm
SO ./pics/redbrick.xpm
WE ./pics/wood.xpm
EA ./pics/bluestone.xpm
F 150,150,150
C 150,150,150

11111111111111111111
110000000000000001111
100000000000000000011
100000000000000000001
100000000000000000011
10000000000000000011
1111001111111111111
1100000100001011
1110111011100011
11E0000100000011
1110111011111111
 1111111111
 1111  1111