



NO ./pics/eagle.xpm
SO ./pics/purplestone.xpm
WE ./pics/wood.xpm
EA ./pics/colorstone.xpm






F 220,223,0
C 220,0,0

1111
1W1
1111